14 14 0 0 14 0 14 2 1 1 1 1 1 11 4 4 6 0 0 0 14 14 5 6 14 14 14 0 0 0 
0 0 0 14 0 14 14 2 1 1 1 1 1 9 0 0 0 0 14 14 0 14 0 14 14 14 14 0 0 14 
14 14 14 14 14 14 14 2 1 1 1 1 11 6 0 0 14 14 14 14 14 0 0 0 14 0 14 14 0 14 
14 7 3 8 14 14 7 12 1 1 1 1 9 0 0 0 0 0 14 0 0 0 0 14 14 14 14 0 0 14 
0 2 1 9 14 14 2 1 1 1 1 1 9 0 14 0 0 14 0 0 14 0 14 0 14 14 0 14 0 14 
0 5 10 9 14 0 2 1 1 1 1 1 13 8 0 0 0 14 0 14 14 14 14 0 0 14 0 14 0 14 
0 14 2 13 3 3 12 1 1 1 1 1 1 13 8 14 0 0 0 0 14 14 14 0 0 0 0 0 0 14 
14 0 5 4 4 10 1 1 1 1 1 1 1 1 13 3 8 0 0 0 0 14 14 14 0 14 0 0 0 14 
14 0 0 0 0 2 1 1 1 1 1 1 1 1 1 11 6 14 0 14 0 0 0 14 14 14 0 0 0 14 
14 0 14 14 14 2 1 1 1 1 1 1 1 1 1 9 0 14 0 0 0 0 14 14 0 14 0 0 0 14 
8 14 14 0 14 2 1 1 1 1 1 1 1 1 11 6 14 0 14 14 0 14 14 14 0 0 14 0 14 0 
13 8 0 0 0 2 1 1 1 1 1 1 11 4 6 14 14 0 0 7 8 0 14 14 0 14 14 0 14 0 
1 9 0 0 0 2 1 1 1 1 1 1 9 14 0 0 0 0 0 2 9 14 0 0 14 14 14 14 0 14 
1 9 14 0 7 12 1 1 1 1 1 1 9 0 0 14 14 0 14 5 16 3 8 0 0 0 0 14 0 14 
1 9 14 14 5 10 1 1 1 1 1 1 9 0 0 0 0 14 14 14 2 1 9 14 0 0 0 14 14 7 
1 13 8 0 0 2 1 1 1 1 1 1 9 14 0 14 14 14 14 14 5 10 9 14 0 7 3 3 3 12 
1 1 9 0 0 2 1 1 1 1 1 1 13 8 14 0 0 0 14 0 0 2 9 0 0 2 1 1 1 1 
1 1 9 14 0 2 1 1 1 1 1 1 11 6 14 0 0 0 14 0 0 2 9 0 0 2 1 1 1 1 
1 11 6 0 0 5 10 1 1 1 1 1 9 0 0 0 14 0 14 14 0 5 6 14 0 2 1 1 1 1 
1 9 14 0 0 0 2 1 1 1 1 1 9 14 0 0 14 0 14 0 14 0 0 0 7 12 1 1 1 1 
4 6 14 14 14 14 2 1 1 1 1 1 13 3 3 3 3 3 8 14 14 0 14 0 5 4 4 10 1 1 
0 0 0 7 3 3 12 1 1 1 1 1 1 1 1 1 1 1 13 3 3 8 0 0 14 0 14 5 4 4 
0 14 0 2 1 1 1 1 1 1 1 1 1 1 1 1 1 1 1 1 1 13 3 8 14 0 14 14 0 0 
14 7 3 12 1 11 4 4 4 10 1 1 1 1 1 1 11 4 4 4 10 1 1 9 0 14 0 0 0 14 
0 5 4 4 4 6 0 14 14 5 10 1 1 1 1 1 9 0 0 0 5 4 10 9 0 0 0 14 0 0 
14 0 0 14 0 0 0 0 14 0 5 4 4 10 1 1 9 14 0 0 14 0 2 13 3 8 0 0 0 14 
0 14 14 14 0 14 14 0 0 14 0 14 14 5 10 1 9 14 0 14 14 0 2 1 1 9 0 14 0 0 
0 0 14 0 14 14 0 14 0 14 0 0 14 0 5 4 6 0 14 0 14 0 5 4 10 13 8 0 0 14 
0 14 0 14 14 0 0 0 0 0 0 14 0 14 0 14 0 14 14 14 14 0 14 0 5 4 6 14 14 14 
14 0 0 0 14 0 0 0 0 14 14 14 0 14 14 14 0 0 0 0 14 14 0 0 0 14 14 0 0 14 
