8 2 1 13 8 14 0 0 14 2 11 6 2 13 12 1 9 0 14 0 5 6 14 7 8 2 1 9 14 0 
6 5 4 4 6 0 7 8 14 2 13 8 2 11 4 4 6 0 0 14 7 3 3 12 9 2 1 9 0 0 
0 0 14 0 0 0 2 13 8 2 11 6 5 6 14 7 8 0 14 0 5 4 10 11 6 5 4 6 0 0 
8 14 0 0 7 3 12 11 6 5 6 0 14 0 0 5 6 7 3 8 0 14 2 13 8 0 0 14 0 0 
6 0 14 0 2 11 4 6 0 14 0 14 14 0 14 14 0 2 11 6 0 0 5 4 6 0 0 0 0 14 
0 7 3 8 5 6 14 0 0 0 0 0 7 3 3 8 0 5 6 14 14 7 8 0 0 0 0 7 3 3 
14 2 1 9 14 14 14 7 3 3 3 3 12 1 11 6 14 0 14 14 7 12 9 0 0 7 8 5 4 10 
8 2 11 6 7 3 3 12 11 10 11 4 10 11 6 7 3 8 14 0 2 1 9 7 8 2 9 0 7 12 
6 2 9 14 2 11 10 11 6 2 9 14 5 6 0 2 11 6 7 3 12 11 6 5 6 2 9 0 2 1 
0 5 6 0 5 6 5 6 0 2 13 8 0 0 14 5 6 7 12 1 11 6 7 3 3 12 13 8 5 10 
0 0 14 0 7 3 3 3 3 12 11 6 0 7 3 3 8 5 10 1 9 7 12 11 10 1 1 9 0 5 
7 3 8 14 5 10 1 11 4 10 9 14 0 2 1 1 9 7 12 1 13 12 1 9 2 11 10 13 3 8 
2 1 9 7 3 12 11 6 0 5 6 0 0 5 4 10 13 12 1 11 4 4 10 13 12 13 12 1 11 6 
2 1 9 2 1 1 9 7 3 8 0 14 0 7 3 12 1 1 1 13 3 3 12 11 4 10 1 11 6 14 
12 1 9 5 4 10 9 2 11 6 7 3 8 5 4 10 11 10 11 10 11 10 1 13 8 5 4 6 0 0 
11 10 9 0 14 5 6 5 6 0 5 4 6 0 0 2 13 12 9 5 6 5 4 4 6 14 0 0 0 0 
9 2 9 14 0 14 0 0 0 7 8 0 14 7 8 5 4 4 6 7 8 7 8 0 0 0 14 7 8 0 
13 12 9 14 0 0 0 14 14 5 6 14 14 2 13 3 3 8 0 5 6 2 13 8 0 0 0 2 13 8 
4 4 6 0 0 0 0 0 0 7 8 14 0 2 11 10 11 6 0 0 0 5 10 13 8 0 14 2 1 13 
0 0 7 3 8 7 8 0 0 2 13 8 0 2 9 2 9 0 0 14 0 0 5 4 6 7 8 2 1 11 
0 0 5 4 6 5 6 0 0 2 1 13 8 2 9 2 9 0 7 8 7 8 0 14 0 2 9 2 11 6 
0 14 14 0 7 8 7 3 3 12 1 1 9 2 9 5 6 0 5 6 2 13 8 0 0 5 6 2 13 8 
0 7 3 3 12 13 12 1 1 11 4 4 6 5 6 0 0 14 0 0 2 1 9 0 14 0 0 5 4 6 
0 2 11 4 10 11 4 10 1 13 3 3 8 0 0 0 0 7 3 8 2 1 9 0 0 0 14 0 0 7 
0 2 13 3 12 9 0 5 10 11 4 10 9 7 3 8 7 12 1 13 12 11 6 14 0 0 7 8 7 12 
0 2 1 11 4 6 0 0 2 9 0 2 9 2 11 6 2 11 10 1 1 13 8 14 0 7 12 9 2 1 
8 5 4 6 14 0 14 7 12 9 0 5 6 2 9 0 2 9 5 4 10 11 6 0 0 2 1 9 5 4 
9 0 0 0 14 0 0 5 10 9 0 0 7 12 13 3 12 13 8 0 5 6 0 14 14 2 1 9 0 0 
13 8 7 8 0 0 7 3 12 9 14 0 2 1 11 10 11 10 13 8 7 8 14 0 14 5 4 6 0 0 
4 6 5 6 0 0 2 11 10 13 8 14 5 10 13 12 13 12 11 6 2 9 0 14 0 0 0 7 8 0 
