0 0 5 6 7 8 2 9 7 8 0 0 7 3 12 13 8 14 14 0 7 12 11 10 13 8 14 0 0 7 
3 3 3 3 12 9 2 13 12 13 3 3 12 1 1 11 6 0 0 0 5 4 6 2 11 6 0 0 0 2 
1 11 10 1 11 6 2 1 11 10 1 11 4 10 1 9 0 0 0 0 0 0 0 5 6 0 0 0 0 2 
1 9 5 10 13 3 12 1 9 2 11 6 0 2 1 9 0 0 0 0 7 8 0 0 0 0 0 0 0 2 
4 6 0 2 1 11 4 4 6 5 6 0 0 2 1 13 3 3 3 3 12 9 0 0 0 0 0 0 0 5 
14 0 0 5 10 9 0 0 0 0 0 0 0 5 10 11 4 4 4 4 10 9 0 0 0 0 0 0 0 0 
15 0 0 0 2 9 0 0 0 0 0 0 0 0 5 6 0 0 0 0 2 13 3 8 0 14 0 0 0 0 
14 0 0 0 2 13 3 8 0 0 0 0 0 0 0 0 0 0 0 0 5 4 4 6 0 0 0 0 0 0 
14 0 0 0 5 4 4 6 0 0 0 0 0 0 0 0 0 0 0 0 0 0 0 0 0 0 0 0 0 0 
0 0 0 7 3 8 0 0 0 0 0 0 0 0 0 0 0 0 0 0 0 0 0 0 0 0 0 0 0 0 
8 0 0 2 1 13 8 0 0 0 0 0 0 0 0 0 0 0 0 0 0 0 0 0 0 0 0 0 0 0 
13 8 0 2 1 1 9 0 0 0 0 0 0 0 0 0 0 0 0 0 0 0 0 0 0 0 0 0 0 0 
4 6 0 5 10 1 13 3 3 3 3 8 0 0 0 0 0 0 0 0 0 0 0 0 0 0 0 0 0 0 
15 0 0 0 5 10 11 10 11 10 11 6 0 0 0 0 0 0 0 0 0 0 0 0 0 0 0 0 0 0 
3 8 0 0 0 2 9 5 6 2 9 0 0 0 0 0 0 0 0 0 0 0 0 0 0 0 0 0 0 0 
10 9 0 0 0 2 13 3 3 12 9 0 0 0 0 0 0 0 0 0 0 0 0 0 0 0 0 0 0 0 
5 6 0 0 0 2 11 4 10 1 9 0 0 0 0 0 0 0 0 0 0 0 0 0 0 0 0 0 0 0 
3 8 0 0 0 5 6 0 5 10 9 0 0 0 0 0 0 0 0 0 0 0 0 0 0 0 0 0 0 0 
11 6 0 0 0 0 0 0 0 2 9 0 0 0 0 0 0 0 0 0 0 0 0 0 0 0 0 0 0 0 
6 0 0 0 0 0 0 0 0 2 9 0 0 0 0 0 0 0 0 0 0 0 0 0 0 0 0 0 0 0 
3 8 0 0 0 0 0 0 0 5 6 0 0 0 0 0 0 0 0 0 0 0 0 0 0 0 0 0 0 0 
4 6 0 0 0 0 0 0 0 0 0 0 0 0 0 0 0 0 0 0 0 0 0 0 0 0 0 0 0 0 
14 0 0 0 0 0 0 0 0 0 0 0 0 0 0 0 0 0 0 0 0 0 0 0 0 0 0 0 0 0 
15 0 0 0 0 0 0 0 0 0 0 0 0 0 0 0 0 0 0 0 0 0 0 0 0 0 0 0 0 0 
14 0 0 0 0 0 0 0 0 0 0 0 0 0 0 0 0 0 0 0 0 0 0 0 0 0 0 0 0 0 
0 0 0 0 0 0 0 0 0 0 0 0 0 0 0 0 0 0 0 0 0 0 0 0 0 0 0 0 0 0 
14 0 0 0 0 0 0 0 0 0 0 0 0 0 0 0 0 0 0 15 0 0 0 0 0 0 0 0 0 0 
15 0 0 0 0 0 0 0 0 0 0 0 0 0 0 0 0 0 0 0 0 0 0 0 0 0 0 0 0 0 
14 0 0 0 0 0 0 0 0 0 0 0 0 0 0 0 0 0 0 0 0 0 0 7 8 0 0 0 0 0 
0 0 0 0 0 0 0 0 0 0 0 0 0 0 0 0 0 0 0 0 0 0 0 2 13 3 3 8 0 0 
