14 14 0 14 0 5 6 14 0 14 14 0 14 0 14 14 0 14 0 14 14 14 0 0 14 0 14 0 0 14 
0 0 0 14 0 14 0 14 14 14 0 14 14 0 14 0 0 14 14 14 0 0 14 0 0 14 0 14 0 14 
14 14 0 0 14 14 0 14 0 14 0 0 0 14 0 0 0 14 0 14 0 0 14 14 0 14 0 14 14 14 
0 0 0 0 7 8 0 0 14 0 14 0 0 0 0 0 0 7 3 8 7 8 0 14 0 0 14 14 0 14 
14 0 0 0 2 13 8 7 8 14 14 14 14 14 14 0 0 5 4 16 17 6 0 0 14 14 0 14 0 7 
14 0 0 0 5 4 6 5 6 14 0 0 0 0 0 14 0 0 7 17 16 8 0 0 14 14 14 0 7 12 
14 0 14 14 7 3 3 8 14 14 0 14 14 14 14 0 14 7 12 9 5 6 0 0 14 0 0 14 5 4 
14 14 14 14 5 4 10 9 14 0 7 8 14 14 0 14 14 2 11 16 3 3 3 8 0 0 0 0 14 14 
0 0 0 14 0 0 5 6 14 14 2 9 0 14 0 0 0 5 6 2 11 4 10 9 14 0 0 14 0 0 
14 14 0 0 0 14 14 14 14 0 5 6 0 0 0 0 0 0 7 12 13 8 2 9 0 0 7 8 0 0 
14 0 0 0 7 8 0 0 14 14 0 14 0 0 0 0 14 0 2 1 1 13 12 9 0 0 5 6 14 14 
0 14 14 14 5 6 0 0 0 14 0 14 14 0 0 14 0 0 5 10 11 10 1 9 7 3 8 14 0 0 
14 14 14 0 0 0 0 0 14 14 14 0 0 0 0 0 0 7 8 5 16 12 11 16 17 10 9 14 0 0 
14 14 0 0 0 14 0 0 14 0 14 0 0 0 14 14 7 17 6 15 5 4 6 2 9 2 13 3 8 14 
14 0 14 14 0 14 14 0 0 0 14 14 0 0 14 7 17 6 7 8 7 3 3 12 13 12 1 1 9 14 
14 0 14 14 0 14 0 0 0 0 0 0 0 14 14 2 9 7 12 9 5 10 1 11 10 11 4 4 6 14 
0 0 14 0 14 14 0 14 14 0 14 14 0 0 0 5 16 12 1 9 7 12 1 13 17 6 7 8 0 14 
0 0 14 0 0 0 0 0 14 0 14 0 14 0 0 7 12 11 10 9 5 4 10 11 6 15 5 6 0 14 
14 14 14 0 14 14 0 0 0 0 0 0 0 0 7 12 1 9 5 6 7 3 17 6 15 15 7 8 0 14 
14 14 0 14 0 0 14 0 0 0 7 8 7 3 12 1 1 13 8 7 12 11 6 7 8 15 2 9 0 14 
0 14 14 0 0 0 14 14 0 7 12 13 12 11 10 1 1 1 13 12 1 9 15 5 6 15 2 9 0 0 
14 14 0 0 14 14 7 8 0 5 4 4 4 6 2 11 10 1 11 10 1 9 15 7 3 3 17 16 8 0 
0 0 7 8 14 0 5 6 0 0 7 3 8 15 2 13 17 10 13 12 11 16 8 2 11 4 6 5 6 0 
14 0 5 6 14 14 0 0 14 0 2 11 6 15 5 10 9 2 11 4 6 2 13 12 9 15 7 8 0 0 
0 0 14 7 8 14 14 0 0 7 17 6 15 15 7 12 9 2 13 3 3 17 4 10 9 7 17 6 0 14 
14 14 14 5 6 0 0 14 14 5 6 0 0 0 5 4 6 5 10 11 10 9 15 5 16 17 6 0 0 0 
0 0 0 0 7 3 8 0 0 14 14 14 0 0 14 0 0 7 12 13 12 13 8 0 5 6 0 14 0 0 
0 14 0 0 5 10 13 8 0 14 0 0 0 14 0 14 0 5 4 4 4 4 6 0 14 0 14 0 0 0 
14 0 0 0 0 5 4 6 14 14 14 0 14 0 14 0 0 14 0 0 0 0 0 0 14 0 0 14 0 0 
0 0 14 0 14 14 14 14 0 14 0 0 14 0 14 0 14 14 0 14 14 0 14 0 14 0 0 0 0 0 
