11 16 12 1 13 8 2 1 9 7 0 0 14 14 0 14 14 14 0 14 0 14 0 0 14 14 0 0 14 0 
16 12 1 11 4 6 2 11 16 16 0 0 14 14 0 0 0 14 0 0 14 14 14 14 14 14 0 0 0 14 
12 1 11 6 7 3 16 8 2 11 0 14 14 14 14 0 0 0 14 14 0 0 14 0 0 0 0 0 14 14 
4 10 9 15 2 1 11 16 16 3 14 14 0 0 0 0 14 14 14 0 0 14 0 14 14 14 14 14 14 14 
15 2 9 15 2 11 16 16 16 12 14 0 0 0 7 0 14 14 0 14 0 15 14 0 0 0 0 14 7 8 
7 16 8 15 2 13 16 16 12 11 0 14 0 14 0 7 0 0 0 14 14 15 14 0 0 14 14 14 0 15 
2 11 6 15 2 11 4 4 4 16 8 14 14 15 14 0 0 14 14 14 0 14 14 0 14 0 0 0 0 7 
5 16 8 7 16 8 7 8 7 12 13 0 7 3 0 14 0 0 14 0 14 14 14 14 14 0 0 14 0 14 
7 12 13 16 16 8 2 0 5 10 11 14 14 5 16 3 3 3 0 0 14 0 14 14 14 0 0 14 0 0 
5 4 10 1 11 6 5 14 14 0 0 15 0 15 2 1 11 4 0 7 3 0 14 0 0 0 0 14 14 0 
0 14 5 4 14 0 14 0 0 0 0 7 0 0 5 4 16 14 14 5 0 0 0 0 14 14 14 0 0 14 
14 14 0 14 0 15 0 14 7 0 14 5 6 0 0 0 5 0 15 7 0 14 15 14 0 0 14 0 0 0 
14 0 0 14 14 0 14 7 14 14 15 7 8 7 8 14 14 14 15 5 6 0 14 0 7 14 14 14 14 0 
14 14 0 0 0 0 0 14 14 14 0 14 0 0 7 8 15 15 7 8 7 8 15 15 5 14 14 14 0 14 
0 0 0 14 0 0 14 0 0 14 14 14 0 0 5 16 8 15 2 9 5 16 3 8 14 0 0 15 7 0 
0 0 0 14 7 8 0 0 0 14 14 14 0 15 7 12 9 7 16 3 3 12 11 6 14 14 14 7 12 14 
0 14 14 14 0 0 0 14 14 7 0 0 7 3 16 12 13 16 16 12 1 11 16 8 7 8 7 12 1 0 
14 15 0 14 14 14 15 7 14 14 0 15 5 4 10 11 4 10 1 11 10 9 2 13 16 3 16 16 16 14 
0 15 15 15 15 14 14 14 0 7 3 8 15 7 16 3 3 12 1 9 5 16 12 11 4 10 1 11 10 0 
14 0 15 7 8 7 14 14 7 12 1 13 8 2 1 11 4 10 11 6 7 16 12 9 15 2 14 14 14 14 
0 14 7 12 13 16 3 3 12 1 11 4 6 2 1 13 8 2 13 3 12 1 11 6 7 12 0 14 0 0 
14 0 14 2 1 1 1 11 10 1 9 15 15 5 10 1 13 16 12 11 10 11 16 8 5 4 14 0 14 14 
8 15 14 5 4 4 10 9 5 10 13 3 8 7 12 1 11 10 1 13 16 8 5 6 7 14 14 14 14 14 
0 0 14 15 15 15 2 13 8 2 1 11 16 16 12 1 9 5 4 4 4 6 15 15 5 14 14 0 0 0 
0 14 0 15 7 8 2 11 16 16 0 14 2 1 11 4 6 15 15 7 3 8 7 0 14 14 0 0 14 7 
0 14 15 7 16 8 5 6 14 0 0 0 2 1 9 15 7 8 7 16 16 3 16 0 14 0 14 14 14 0 
0 0 7 12 1 9 15 15 0 0 7 0 5 4 16 3 12 9 5 10 11 10 1 9 0 0 15 15 7 14 
14 15 2 11 10 13 8 15 14 0 2 0 0 15 14 0 14 14 14 0 7 12 11 6 15 15 15 7 16 0 
0 15 2 13 16 16 0 0 14 0 14 0 0 15 0 14 14 0 14 14 14 0 15 14 0 14 0 14 14 14 
14 0 14 0 0 14 0 14 0 14 0 14 0 0 14 14 14 14 0 0 0 0 0 0 0 14 14 0 0 14 
