14 14 0 0 14 0 14 0 0 14 14 0 14 14 0 14 14 0 0 0 14 14 14 0 0 14 14 0 0 0 
14 0 0 0 14 0 14 14 14 0 0 14 14 0 0 14 0 0 14 0 0 14 0 14 14 0 0 14 0 14 
0 0 0 0 0 14 0 0 0 14 14 14 0 14 14 14 0 0 0 0 14 14 0 14 14 14 14 0 14 14 
14 0 0 0 14 0 14 0 0 0 14 15 15 15 0 0 14 14 14 7 3 3 3 3 8 7 14 0 14 0 
14 0 14 14 14 0 0 14 14 14 0 7 3 3 3 3 3 8 15 5 10 11 4 10 9 5 14 0 14 14 
14 0 0 14 0 0 0 0 0 0 14 14 5 10 11 10 1 13 3 3 12 13 8 14 14 0 0 0 0 14 
0 14 0 0 0 14 0 14 14 0 14 14 15 2 9 2 1 11 10 11 10 11 16 0 0 14 15 0 15 0 
0 0 14 14 14 0 14 14 0 14 14 7 3 12 13 12 1 9 5 16 16 3 12 9 7 0 0 0 15 14 
0 0 14 14 0 0 14 14 14 15 7 12 1 1 11 10 11 6 7 16 16 12 11 16 16 3 8 0 0 0 
0 0 0 14 14 14 14 0 0 15 5 4 4 4 6 5 6 7 12 11 10 1 13 16 16 16 8 0 14 7 
0 14 14 0 14 0 14 0 14 7 8 15 7 3 8 15 7 12 11 16 12 11 10 11 10 11 6 15 15 2 
14 0 0 0 15 14 0 0 0 5 6 15 5 10 9 15 5 10 9 5 10 13 12 9 2 9 15 7 8 5 
14 15 15 7 3 3 14 0 7 3 8 15 7 16 3 3 3 12 9 15 2 1 11 16 16 3 3 16 3 8 
14 0 7 12 11 10 13 3 16 12 9 15 2 1 11 10 11 10 9 7 16 16 3 14 0 2 1 11 4 6 
0 0 5 10 9 5 4 10 11 4 6 7 12 11 6 2 13 12 9 5 4 4 14 14 0 5 4 6 15 7 
0 15 15 5 6 7 8 5 6 7 8 2 11 16 3 12 1 1 9 15 14 14 0 14 14 0 15 7 3 16 
0 14 7 8 15 2 9 7 3 16 8 5 6 2 11 10 11 4 16 3 14 14 14 0 14 14 15 2 11 4 
8 14 5 16 3 12 13 16 12 11 6 15 7 16 8 5 16 3 12 11 6 14 0 14 0 0 0 14 0 7 
0 0 15 2 11 10 11 4 10 9 15 15 5 10 13 8 5 4 10 9 7 14 15 0 0 0 14 0 0 2 
14 0 0 0 0 0 0 0 0 14 14 0 14 5 10 9 7 3 12 0 0 14 15 0 14 0 14 0 14 14 
0 14 0 14 0 14 0 14 14 0 14 14 0 7 16 3 16 12 1 0 0 14 15 14 0 14 0 14 14 0 
14 0 14 14 14 0 0 0 14 0 15 7 3 12 1 11 10 11 10 0 0 0 0 14 0 0 0 14 15 7 
0 15 15 14 14 0 15 14 0 14 15 2 1 1 1 13 16 3 12 13 8 15 0 14 0 14 14 14 0 5 
0 15 0 14 7 14 7 14 0 14 7 12 1 1 1 1 1 11 4 4 16 0 0 0 0 14 14 0 0 7 
0 15 14 14 14 14 2 13 14 14 5 4 10 1 1 1 1 9 7 8 5 14 14 14 14 14 0 7 8 5 
14 14 0 7 14 0 0 0 14 7 3 3 12 1 1 1 11 6 5 16 3 14 0 14 14 14 14 14 0 0 
0 14 14 0 0 7 8 15 15 2 11 4 10 1 1 1 9 15 7 12 1 0 14 0 14 0 14 0 14 0 
14 14 0 0 0 2 13 8 7 14 0 7 12 11 4 10 13 3 12 11 10 0 0 0 14 14 0 0 14 0 
0 14 0 0 14 0 2 13 12 14 0 0 14 7 3 14 0 2 0 14 2 9 14 0 15 0 14 0 14 0 
0 14 0 0 0 0 14 0 14 14 7 3 14 14 14 0 14 14 14 0 14 0 0 14 0 0 0 14 14 14 
